222222222222222222222222222222222222222222222222222222222222222222222222222222222222222222222222
200000000000000000000000000000000000000000000000000000000000000000000000000000000000000000000002
200000000000000000000000000000000000000000000000000000000000000000000000000000000000000000000002
200000000000000000000000000000000000000000000000000000000000000000000000000000000000000000000002
200000000000000000000000000000000000000000000000000000000000000000000000000000000000000000000002
200000000000000000000000000000000000000000000000000000000000000000000000000000000000000000000002
200000000000000000000000000000000000000000000000000000000000000000000000000000000000000000000002
200000000000000000000000000000000000000000000000000000000000000000000000000000000000000000000002
200000001100000000000000000000000000000000000000000000000000000000000000000000000000001100000002
200000001100000000000000000000000000000000000000000000000000000000000000000000000000001100000002
200000001100000000000000000000000000000000000000000000000000000000000000000000000000001100000002
200000001100000000000000000000000000000000000000000000000000000000000000000000000000001100000002
200000001100000000000000000000000000000000000000000000000000000000000000000000000000001100000002
200000001100000000000000000000000000000000000000000000000000000000000000000000000000001100000002
200000001100000000000000000000000000000000000000000000000000000000000000000000000000001100000002
200000001100000000000000000000000000000000000000000000000000000000000000000000000000001100000002
200000001100000000000000000000000000000000000000000000000000000000000000000000000000001100000002
200000000000000000000000000000000000000000000000000000000000000000000000000000000000000000000002
200000000000000000000000000000000000000000000000000000000000000000000000000000000000000000000002
200000000000000000000000000000000000000000000000000000000000000000000000000000000000000000000002
200000000000000000000000000000000000000000000000000000000000000000000000000000000000000000000002
200000000000000000000000000000000000000000000000000000000000000000000000000000000000000000000002
200000000000000000000000000000000000000000000000000000000000000000000000000000000000000000000002
200000000000000000000000000000000000000000000000000000000000000000000000000000000000000000000002
200000000000000000002222222222222222222222222222222222222222222222222222222200000000000000000002
211111111111111111112222222222222222222222222222222222222222222222222222222211111111111111111112
211111111111111111112222222222222222222222222222222222222222222222222222222211111111111111111112
200000000000000000002222222222222222222222222222222222222222222222222222222200000000000000000002
200000000000000000000000000000000000000000000000000000000000000000000000000000000000000000000002
200000000000000000000000000000000000000000000000000000000000000000000000000000000000000000000002
200000000000000000000000000000000000000000000000000000000000000000000000000000000000000000000002
200000000000000000000000000000000000000000000000000000000000000000000000000000000000000000000002
200000000000000000000000000000000000000000000000000000000000000000000000000000000000000000000002
200000000000000000000000000000000000000000000000000000000000000000000000000000000000000000000002
200000000000000000000000000000000000000000000000000000000000000000000000000000000000000000000002
200000001100000000000000000000000000000000000000000000000000000000000000000000000000001100000002
200000001100000000000000000000000000000000000000000000000000000000000000000000000000001100000002
200000001100000000000000000000000000000000000000000000000000000000000000000000000000001100000002
200000001100000000000000000000000000000000000000000000000000000000000000000000000000001100000002
200000001100000000000000000000000000000000000000000000000000000000000000000000000000001100000002
200000001100000000000000000000000000000000000000000000000000000000000000000000000000001100000002
200000001100000000000000000000000000000000000000000000000000000000000000000000000000001100000002
200000001100000000000000000000000000000000000000000000000000000000000000000000000000001100000002
200000001100000000000000000000000000000000000000000000000000000000000000000000000000001100000002
200000000000000000000000000000000000000000000000000000000000000000000000000000000000000000000002
200000000000000000000000000000000000000000000000000000000000000000000000000000000000000000000002
200000000000000000000000000000000000000000000000000000000000000000000000000000000000000000000002
200000000000000000000000000000000000000000000000000000000000000000000000000000000000000000000002
200000000000000000000000000000000000000000000000000000000000000000000000000000000000000000000002
200000000000000000000000000000000000000000000000000000000000000000000000000000000000000000000002
200000000000000000000000000000000000000000000000000000000000000000000000000000000000000000000002
222222222222222222222222222222222222222222222222222222222222222222222222222222222222222222222222